NO ./assets/sky_wall01.XPM
SO ./assets/sky_wall01.XPM
WE ./assets/sky_wall01.XPM
EA ./assets/sky_wall01.XPM
F 96,155,29
C 210,230,251

1111111111111111111111111111111111111111111111111
1100000000000011111011110S00000000000000000000001
1111111111110101D10111110000011111111111111111111
111101111111111111000111110011
100000000011000000000000000001
10110000001100000000000100000111111111
11111111100100000000000000000000000001
11111111101100000111000000000000000001
10000000000000000111011111111111111111
11111111111111111111111111111111111111