NO ./assets/sky_wall01.XPM
SO ./assets/sky_wall01.XPM
WE ./assets/sky_wall01.XPM
EA ./assets/sky_wall01.XPM
F 96,155,29
C 210,230,251

1111111111111111111111111111111111111111111111111
1100000000000011111011110S00000000000000000000001
1111111111110101010111110000011111111111111111111
1111011111111111110001DDDDDDD1
1000000000110000000000DD000001
10110000001100000000000000000111111111
111111111001000000000D0000000000000001
11111111101100000111000000000000000001
10000000000000000111011111111111111111
11111111111111111111111111111111111111