NO ./assets/sky_wall01.XPM
SO ./assets/sky_wall01.XPM
WE ./assets/sky_wall01.XPM
EA ./assets/sky_wall01.XPM
F 96,155,29
C 210,230,251

1111111111111111111111111111111111111111111111111111
1000000000000000000000000000000000000000000000000001
1000000000000000000000000000000000000000000000000001
1000000000000000000000000000000000000000000000000001
100000000000000000000000E000000000000000000000000001
1000000000000000000000000000000000000000000000000001
1000000000000000000000000000000000000000000000000001
1000000000000000000000000000000000000000000000000001
1111111111111111111111111111111111111111111111111111