NO ./assets/sky_wall01.XPM
SO ./assets/sky_wall01.XPM
WE ./assets/sky_wall01.XPM
EA ./assets/sky_wall01.XPM
F 96,155,29
C 210,230,251

1111111111111111111111111111111111111111111111111111
1000000000000000000100000000000000000000000100000001
1000000010000000000100000000111000000000011100000001
1000000010000000000011000000011100000011111111110001
100000001000000000000100E000111000000111111111100001
1001111111111111111111100000011100000000000000000001
1000000000000000000000000000111111111111110000001111
1000000000000000000000000000000000000000000000000001
1111111111111111111111111111111111111111111111111111